############################
#............##............#
#.#####.####.##.#####.####.#
#O#####.####.##.#####.####O#
#.#####.####.##.#####.####.#
#..........................#
#.####.##.########.##.####.#
#.####.##.########.##.####.#
#......##....##....##......#
######.#####*##*#####.######
######.#####*##*#####.######
######.##**********##.######
######.##*########*##.######
######.##*########*##.######
******.***########***.******
######.##*########*##.######
######.##*########*##.######
######.##**********##.######
######.##*########*##.######
######.##*########*##.######
#............##............#
#.####.#####.##.#####.####.#
#.####.#####.##.#####.####.#
#O..##................##..O#
###.##.##.########.##.##.###
###.##.##.########.##.##.###
#......##....##....##......#
#.##########.##.##########.#
#.##########.##.##########.#
#..........................#
############################